{
"level-1":{
	"width":17,
	"height":17,
	"tiles":[
	[0,0,0,0,0,0,0,0,0,0,0,0,0,0,0,0,0],
	[0,0,0,0,0,0,0,0,0,0,0,0,0,0,0,0,0],
	[0,0,0,0,0,0,0,0,0,0,0,0,0,0,0,0,0],
	[0,0,0,0,0,0,0,0,0,0,0,0,0,0,0,0,0],
	[0,0,0,0,0,8,0,1,3,1,0,8,0,0,0,0,0],
	[0,0,0,0,1,1,6,1,4,1,6,1,1,0,0,0,0],
	[0,0,0,0,0,6,0,0,0,0,0,1,0,0,0,0,0],
	[0,0,0,0,0,1,5,0,7,0,0,1,0,0,0,0,0],
	[0,0,0,0,1,1,8,0,2,0,8,1,1,0,0,0,0],
	[0,0,0,0,0,1,0,0,0,0,5,1,0,0,0,0,0],
	[0,0,0,0,0,1,0,0,8,0,0,6,0,0,0,0,0],
	[0,0,0,0,1,1,1,1,1,1,1,1,1,0,0,0,0],
	[0,0,0,0,0,1,0,0,1,0,0,1,0,0,0,0,0],
	[0,0,0,0,0,0,0,0,0,0,0,0,0,0,0,0,0],
	[0,0,0,0,0,0,0,0,0,0,0,0,0,0,0,0,0],
	[0,0,0,0,0,0,0,0,0,0,0,0,0,0,0,0,0],
	[0,0,0,0,0,0,0,0,0,0,0,0,0,0,0,0,0]
	]
},

"level-2":{
	"width":9,
	"height":9,
	"tiles":[
	[0,0,0,0,0,0,0,0,0],
	[0,0,0,0,0,0,0,0,0],
	[0,0,0,0,0,0,0,0,0],
	[0,0,0,0,0,0,0,0,0],
	[0,0,0,0,0,0,0,0,0],
	[0,0,0,0,0,0,0,0,0],
	[0,0,0,0,0,0,0,0,0],
	[0,0,0,0,0,0,0,0,0],
	[0,0,0,0,0,0,0,0,0]
]
}
}
